111111111111111111111111111111
1E0000000000000000010000000001
111111111110101010100110111011
101000011000000000001110111001
10C010010000111111100111111101
111110111110100100111110000001
1000000T00C0101110111111011111
1000000000C0101110111111011111
1000000000C0101110111111011111
10T0000000C0101110111111011111
111011111010101110110000010001
100010001000100000110100000001
101000101111111011110111111111
1C101010000000000000P000000001
111111111111111111111111111111
111111111111111111111111111111