111111111
10E100001
10110C101
100001101
111100001
10C000001
1111110C1
101P00001
111111111