1111111
1E10001
100C101
111T0C1
10000P1
1111111